16
11
1111111101111111
1000000000000001
1000000000000001
1001100110001101
1000000000000001
@001000r01000101
1000100010001001
1000000000000001
1001100110001101
1000000000000001
1111111111111111