16
11
1111111111111111
1000r00000000001
10wwww0000wwww01
10wwww0000wwww01
10www0000000ww01
@0www0wwwww0wwr0
10www0wwwww0ww01
10www0000000ww01
10wwww0000wwww01
1000r00000000001
1111111111111111