16
11
1111111111111111
1000000000000001
100r000000000001
100000r000000001
1000000000000001
1000000000000000
1000000000000001
1000000000000001
100r000000000001
10000000@0000001
1111111111111111