16
11
1111111111111111
1000r00000000001
1011110000111101
1011110000111101
1011100000001101
@0111011111011r0
1011101111101101
1011100000001101
1011110000111101
1000r00000000001
1111111111111111