16
11
1111111111111111
1111111111111111
11r0001000111r11
1101101010001011
1101101011101011
@001101011101000
11011010111r1011
1101100011101011
1101100011100011
1111111111111111
1111111111111111