16
11
1111111101111111
10000r0000000001
1000000000000001
1000000000000001
100000r110000001
1000000110000001
1000000110000001
1000r00000000001
1000000000000001
10000000@0000001
1111111101111111