16
11
1111111111111111
1000000000000001
1000000000000001
1000000000000001
100000111100r001
10000011110r0000
1000001111000001
1000000000r00001
100r000000000001
1000000000000001
11111111@1111111