16
11
1111111111111111
1000000000r00001
1000000000000001
1000000000000001
100010r00r010001
00000000r0000000
10001r0000010001
1000000000000001
1000000000000001
10000000@0000001
1111111101111111