16
11
1111111111111111
1000000000000001
10000r000000r001
1000100000010001
100000000r0r0001
@000000000000r01
100000000r0r0001
1000100000010001
1000000000000r01
1000000000000001
1111111111111111