16
11
1111111111111111
1000000000111111
1000000000011111
1000000000001111
1000000000000111
1000000000000001
1000000000000111
1000000000001111
1000000000011111
1000000000111111
11111111@1111111