16
11
1111111101111111
10000000000r0001
1000r00000000001
1000001111000001
1r00001111000001
100000111100000@
10000r1111000001
1000001111000001
100r000000000001
10000000000r0001
1111111111111111