16
11
1111111111111111
1000r00000000001
1000000000000001
10011000r0011001
10011000000110r1
@001100000011001
10011000r0011001
1000000000000001
1000000000000001
1000r00000000001
1111111111111111