16
11
1111111101111111
1000000000000001
1000000000000001
1000000000000001
1000000000000001
0000000000000000
1000000000000001
1000000000000001
100e000000000001
10000000@0000001
1111111111111111